50 50
5 2 2 0    5 2 3 0    5 2 1 0    5 2 1 0    5 2 1 0    5 2 1 0    5 2 1 0    5 2 1 0    5 2 1 0    5 2 1 0    5 2 1 0    5 2 1 0    5 2 1 0    5 2 1 0    5 2 1 0    5 2 1 0    5 2 1 0    5 2 1 0    5 2 1 0    5 2 1 0    5 2 1 0    5 2 1 0    5 2 1 0    5 2 1 0    5 2 1 0    5 0 0 0   5 0 0 0   5 0 0 0   5 0 0 0   5 0 0 0   5 0 0 0   5 0 0 0   5 0 0 0   5 0 0 0   5 0 0 0   5 0 0 0   5 0 0 0   5 0 0 0   5 0 0 0   5 0 0 0   5 0 0 0   5 2 1 0    5 2 1 0    5 2 1 0    5 2 1 0    5 2 1 0    5 2 1 0    5 2 1 0    5 2 1 0    5 2 1 0   
5 2 4 0    5 2 5 0    5 0 0 0   5 0 0 0   5 2 1 0    5 2 1 0    5 2 1 0    5 2 1 0    5 2 1 0    5 2 1 0    5 2 1 0    5 2 1 0    5 2 1 0    5 2 1 0    5 2 1 0    5 2 1 0    5 2 1 0    5 2 1 0    5 2 1 0    5 2 1 0    5 2 1 0    5 2 1 0    5 2 1 0    5 2 1 0    5 0 0 0   5 0 0 0   5 0 0 0   5 0 0 0   5 0 0 0   5 0 0 0   5 0 0 0   5 0 0 0   5 0 0 0   5 0 0 0   5 0 0 0   5 0 0 0   5 0 0 0   5 0 0 0   5 0 0 0   5 0 0 0   5 0 0 0   5 0 0 0   5 0 0 0   5 0 0 0   5 2 1 0    5 2 1 0    5 2 1 0    5 2 1 0    5 2 1 0    5 2 1 0   
5 2 1 0    5 0 0 0   5 0 0 0   5 0 0 0   5 0 0 0   5 2 1 0    5 2 1 0    5 2 1 0    5 2 1 0    5 2 1 0    5 2 1 0    5 2 1 0    5 2 1 0    5 2 1 0    5 2 1 0    5 2 1 0    5 2 1 0    5 2 1 0    5 2 1 0    5 2 1 0    5 2 1 0    5 2 1 0    5 2 1 0    5 2 1 0    5 0 0 0   5 0 0 0   5 0 0 0   5 0 0 0   5 2 1 0    5 2 1 0    5 2 1 0    5 2 1 0    5 0 0 0   5 0 0 0   5 0 0 0   5 0 0 0   5 0 0 0   5 0 0 0   5 0 0 0   5 0 0 0   5 0 0 0   5 0 0 0   5 0 0 0   5 0 0 0   5 0 0 0   5 0 0 0   5 2 1 0    5 2 1 0    5 2 1 0    5 2 1 0   
5 2 1 0    5 0 0 0   5 0 0 0   5 0 0 0   5 0 0 0   5 0 0 0   5 0 0 0   5 2 1 0    5 2 1 0    5 2 1 0    5 2 1 0    5 2 1 0    5 2 1 0    5 2 1 0    5 2 1 0    5 2 1 0    5 2 1 0    5 2 1 0    5 2 1 0    5 2 1 0    5 2 1 0    5 2 1 0    5 2 1 0    5 0 0 0   5 0 0 0   5 0 0 0   5 0 0 0   5 0 0 0   5 2 1 0    5 2 1 0    5 2 1 0    5 2 1 0    5 2 1 0    5 0 0 0   5 0 0 0   5 0 0 0   5 0 0 0   5 0 0 0   5 0 0 0   5 0 0 0   5 0 0 0   5 0 0 0   5 0 0 0   5 0 0 0   5 0 0 0   5 0 0 0   5 0 0 0   5 2 1 0    5 2 1 0    5 2 1 0   
5 2 1 0    5 2 1 0    5 0 0 0   5 0 0 0   5 0 0 0   5 0 0 0   5 0 0 0   5 0 0 0   5 0 0 0   5 0 0 0   5 0 0 0   5 2 1 0    5 2 1 0    5 2 1 0    5 2 1 0    5 2 1 0    5 2 1 0    5 2 1 0    5 2 1 0    5 2 1 0    5 2 1 0    5 2 1 0    5 0 0 0   5 0 0 0   5 0 0 0   5 0 0 0   5 0 0 0   5 0 0 0   5 2 1 0    5 2 1 0    5 2 1 0    5 2 1 0    5 0 0 0   5 0 0 0   5 0 0 0   5 0 0 0   5 0 0 0   5 0 0 0   5 0 0 0   5 0 0 0   5 0 0 0   5 0 0 0   5 0 0 0   5 0 0 0   5 0 0 0   5 0 0 0   5 0 0 0   5 0 0 0   5 2 1 0    5 2 1 0   
5 2 1 0    5 2 1 0    5 1 1 1   5 1 1 1   5 1 1 1   5 1 0 1   5 1 0 1   5 1 0 1   5 1 0 1   5 1 0 1   5 0 0 0   5 0 0 0   5 2 1 0    5 2 1 0    5 2 1 0    5 2 1 0    5 2 1 0    5 2 1 0    5 2 1 0    5 2 1 0    5 2 1 0    5 2 1 0    5 0 0 0   5 0 0 0   5 0 0 0   5 0 0 0   5 0 0 0   5 0 0 0   5 0 0 0   5 0 0 0   5 0 0 0   5 0 0 0   5 0 0 0   5 0 0 0   5 0 0 0   5 0 0 0   5 0 0 0   5 0 0 0   5 0 0 0   5 0 0 0   5 0 0 0   5 0 0 0   5 0 0 0   5 0 0 0   5 0 0 0   5 0 0 0   5 0 0 0   5 0 0 0   5 2 1 0    5 2 1 0   
5 2 1 0    5 2 1 0    5 1 1 1   5 1 1 1   5 1 1 1   5 1 0 1   5 1 0 1   5 1 0 1   5 1 0 1   5 1 0 1   5 0 0 0   5 0 0 0   5 0 0 0   5 0 0 0   5 0 0 0   5 2 1 0    5 2 1 0    5 2 1 0    5 2 1 0    5 2 1 0    5 2 1 0    5 2 1 0    5 0 0 0   5 0 0 0   5 0 0 0   5 0 0 0   5 0 0 0   5 0 0 0   5 0 0 0   5 0 0 0   5 0 0 0   5 0 0 0   5 0 0 0   5 0 0 0   5 0 0 0   5 0 0 0   5 0 0 0   5 0 0 0   5 0 0 0   5 0 0 0   5 0 0 0   5 0 0 0   5 0 0 0   5 0 0 0   5 0 0 0   5 0 0 0   5 0 0 0   5 0 0 0   5 2 1 0    5 2 1 0   
5 2 1 0    5 2 1 0    5 0 0 0   5 0 0 0   5 0 0 0   5 0 0 0   5 0 0 0   5 0 0 0   5 0 0 0   5 0 0 0   5 0 0 0   5 0 0 0   5 0 0 0   5 0 0 0   5 0 0 0   5 2 1 0    5 2 1 0    5 2 1 0    5 2 1 0    5 2 1 0    5 2 1 0    5 0 0 0   5 0 0 0   5 0 0 0   5 0 0 0   5 0 0 0   5 0 0 0   5 0 0 0   5 0 0 0   5 0 0 0   5 0 0 0   5 0 0 0   5 0 0 0   5 0 0 0   5 0 0 0   5 0 0 0   5 0 0 0   5 0 0 0   5 0 0 0   5 0 0 0   5 0 0 0   5 0 0 0   5 0 0 0   5 0 0 0   5 0 0 0   5 0 0 0   5 0 0 0   5 0 0 0   5 0 0 0   5 2 1 0   
5 2 1 0    5 2 1 0    5 2 1 0    5 0 0 0   5 0 0 0   5 0 0 0   5 0 0 0   5 0 0 0   5 0 0 0   5 0 0 0   5 0 0 0   5 0 0 0   5 0 0 0   5 0 0 0   5 0 0 0   5 0 0 0   5 2 1 0    5 2 1 0    5 2 1 0    5 2 1 0    5 2 1 0    5 0 0 0   5 0 0 0   5 0 0 0   5 0 0 0   5 0 0 0   5 0 0 0   5 0 0 0   5 2 1 0    5 2 1 0    5 2 1 0    5 0 0 0   5 0 0 0   5 0 0 0   5 0 0 0   5 0 0 0   5 0 0 0   5 0 0 0   5 0 0 0   5 0 0 0   5 0 0 0   5 0 0 0   5 0 0 0   5 0 0 0   5 0 0 0   5 0 0 0   5 0 0 0   5 0 0 0   5 0 0 0   5 2 1 0   
5 2 1 0    5 2 1 0    5 2 1 0    5 0 0 0   5 0 0 0   5 0 0 0   5 0 0 0   5 0 0 0   5 0 0 0   5 0 0 0   5 0 0 0   5 0 0 0   5 0 0 0   5 0 0 0   5 0 0 0   5 0 0 0   5 0 0 0   5 2 1 0    5 2 1 0    5 2 1 0    5 0 0 0   5 0 0 0   5 0 0 0   5 0 0 0   5 0 0 0   5 0 0 0   5 0 0 0   5 2 1 0    5 2 1 0    5 2 1 0    5 2 1 0    5 0 0 0   5 0 0 0   5 0 0 0   5 0 0 0   5 0 0 0   5 0 0 0   5 0 0 0   5 0 0 0   5 0 0 0   5 0 0 0   5 0 0 0   5 0 0 0   5 0 0 0   5 2 1 0    5 0 0 0   5 0 0 0   5 0 0 0   5 0 0 0   5 2 1 0    
5 2 1 0    5 2 1 0    5 2 1 0    5 0 0 0   5 0 0 0   5 0 0 0   5 0 0 0   5 0 0 0   5 0 0 0   5 0 0 0   5 0 0 0   5 0 0 0   5 0 0 0   5 0 0 0   5 0 0 0   5 0 0 0   5 0 0 0   5 0 0 0   5 0 0 0   5 0 0 0   5 0 0 0   5 0 0 0   5 0 0 0   5 0 0 0   5 0 0 0   5 0 0 0   5 0 0 0   5 0 0 0   5 2 1 0    5 2 1 0    5 2 1 0    5 2 1 0    5 0 0 0   5 0 0 0   5 0 0 0   5 0 0 0   5 0 0 0   5 0 0 0   5 0 0 0   5 0 0 0   5 0 0 0   5 0 0 0   5 0 0 0   5 2 1 0    5 2 1 0    5 2 1 0    5 0 0 0   5 0 0 0   5 0 0 0   5 2 1 0    
5 2 1 0    5 2 1 0    5 2 1 0    5 0 0 0   5 0 0 0   5 0 0 0   5 0 0 0   5 0 0 0   5 0 0 0   5 0 0 0   5 0 0 0   5 0 0 0   5 0 0 0   5 0 0 0   5 0 0 0   5 0 0 0   5 0 0 0   5 0 0 0   5 0 0 0   5 0 0 0   5 0 0 0   5 0 0 0   5 0 0 0   5 0 0 0   5 0 0 0   5 0 0 0   5 0 0 0   5 0 0 0   5 0 0 0   5 2 1 0    5 2 1 0    5 0 0 0   5 0 0 0   5 0 0 0   5 0 0 0   5 0 0 0   5 0 0 0   5 0 0 0   5 0 0 0   5 0 0 0   5 0 0 0   5 0 0 0   5 2 1 0    5 2 1 0    5 2 1 0    5 2 1 0    5 0 0 0   5 0 0 0   5 0 0 0   5 2 1 0    
5 2 1 0    5 2 1 0    5 2 1 0    5 2 1 0    5 0 0 0   5 0 0 0   5 0 0 0   5 0 0 0   5 0 0 0   5 0 0 0   5 0 0 0   5 0 0 0   5 0 0 0   5 0 0 0   5 0 0 0   5 0 0 0   5 0 0 0   5 0 0 0   5 0 0 0   5 0 0 0   5 0 0 0   5 0 0 0   5 0 0 0   5 0 0 0   5 0 0 0   5 0 0 0   5 0 0 0   5 0 0 0   5 0 0 0   5 0 0 0   5 0 0 0   5 0 0 0   5 0 0 0   5 0 0 0   5 0 0 0   5 0 0 0   5 0 0 0   5 0 0 0   5 0 0 0   5 0 0 0   5 0 0 0   5 2 1 0    5 2 1 0    5 2 1 0    5 2 1 0    5 0 0 0   5 0 0 0   5 0 0 0   5 0 0 0   5 2 1 0   
5 2 1 0    5 2 1 0    5 2 1 0    5 2 1 0    5 0 0 0   5 0 0 0   5 0 0 0   5 0 0 0   5 0 0 0   5 0 0 0   5 0 0 0   5 0 0 0   5 0 0 0   5 0 0 0   5 0 0 0   5 0 0 0   5 0 0 0   5 0 0 0   5 0 0 0   5 0 0 0   5 0 0 0   5 0 0 0   5 0 0 0   5 0 0 0   5 0 0 0   5 0 0 0   5 0 0 0   5 0 0 0   5 0 0 0   5 0 0 0   5 0 0 0   5 0 0 0   5 0 0 0   5 0 0 0   5 0 0 0   5 0 0 0   5 0 0 0   5 2 1 0    5 2 1 0    5 2 1 0    5 2 1 0    5 2 1 0    5 2 1 0    5 0 0 0   5 0 0 0   5 0 0 0   5 0 0 0   5 0 0 0   5 0 0 0   5 2 1 0   
5 2 1 0    5 2 1 0    5 2 1 0    5 2 1 0    5 2 1 0    5 0 0 0   5 0 0 0   5 0 0 0   5 0 0 0   5 0 0 0   5 0 0 0   5 0 0 0   5 0 0 0   5 0 0 0   5 0 0 0   5 0 0 0   5 0 0 0   5 0 0 0   5 0 0 0   5 0 0 0   5 2 1 0    5 2 1 0    5 2 1 0    5 2 1 0    5 2 1 0    5 2 1 0    5 2 1 0    5 2 1 0    5 2 1 0    5 0 0 0   5 0 0 0   5 0 0 0   5 0 0 0   5 0 0 0   5 0 0 0   5 0 0 0   5 0 0 0   5 0 0 0   5 0 0 0   5 0 0 0   5 0 0 0   5 0 0 0   5 0 0 0   5 0 0 0   5 0 0 0   5 0 0 0   5 0 0 0   5 0 0 0   5 0 0 0   5 2 1 0    
5 2 1 0    5 2 1 0    5 2 1 0    5 2 1 0    5 2 1 0    5 0 0 0   5 0 0 0   5 0 0 0   5 0 0 0   5 0 0 0   5 0 0 0   5 0 0 0   5 0 0 0   5 0 0 0   5 0 0 0   5 0 0 0   5 0 0 0   5 0 0 0   5 0 0 0   5 2 1 0    5 2 1 0    5 0 0 0   5 0 0 0   5 0 0 0   5 0 0 0   5 0 0 0   5 0 0 0   5 0 0 0   5 2 1 0    5 2 1 0    5 0 0 0   5 0 0 0   5 0 0 0   5 0 0 0   5 0 0 0   5 0 0 0   5 0 0 0   5 0 0 0   5 0 0 0   5 0 0 0   5 0 0 0   5 0 0 0   5 0 0 0   5 0 0 0   5 0 0 0   5 0 0 0   5 0 0 0   5 0 0 0   5 0 0 0   5 2 1 0   
5 2 1 0    5 2 1 0    5 2 1 0    5 2 1 0    5 2 1 0    5 0 0 0   5 0 0 0   5 0 0 0   5 0 0 0   5 0 0 0   5 0 0 0   5 0 0 0   5 0 0 0   5 0 0 0   5 0 0 0   5 0 0 0   5 0 0 0   5 0 0 0   5 0 0 0   5 0 0 0   5 0 0 0   5 0 0 0   5 0 0 0   5 0 0 0   5 0 0 0   5 0 0 0   5 0 0 0   5 0 0 0   5 0 0 0   5 0 0 0   5 0 0 0   5 0 0 0   5 0 0 0   5 2 1 0    5 2 1 0    5 0 0 0   5 0 0 0   5 0 0 0   5 0 0 0   5 0 0 0   5 0 0 0   5 0 0 0   5 0 0 0   5 0 0 0   5 0 0 0   5 0 0 0   5 0 0 0   5 0 0 0   5 0 0 0   5 2 1 0   
5 2 1 0    5 2 1 0    5 2 1 0    5 2 1 0    5 0 0 0   5 0 0 0   5 0 0 0   5 0 0 0   5 0 0 0   5 0 0 0   5 0 0 0   5 0 0 0   5 0 0 0   5 0 0 0   5 0 0 0   5 0 0 0   5 0 0 0   5 0 0 0   5 0 0 0   5 0 0 0   5 0 0 0   5 0 0 0   5 0 0 0   5 0 0 0   5 0 0 0   5 0 0 0   5 0 0 0   5 0 0 0   5 0 0 0   5 0 0 0   5 0 0 0   5 0 0 0   5 2 1 0    5 2 1 0    5 2 1 0    5 2 1 0    5 2 1 0    5 2 1 0    5 2 1 0    5 2 1 0    5 2 1 0    5 2 1 0    5 0 0 0   5 0 0 0   5 0 0 0   5 0 0 0   5 0 0 0   5 0 0 0   5 2 1 0    5 2 1 0   
5 2 1 0    5 2 1 0    5 2 1 0    5 2 1 0    5 0 0 0   5 0 0 0   5 0 0 0   5 0 0 0   5 0 0 0   5 0 0 0   5 0 0 0   5 0 0 0   5 0 0 0   5 0 0 0   5 0 0 0   5 0 0 0   5 0 0 0   5 0 0 0   5 0 0 0   5 0 0 0   5 0 0 0   5 0 0 0   5 0 0 0   5 0 0 0   5 0 0 0   5 0 0 0   5 0 0 0   5 0 0 0   5 0 0 0   5 0 0 0   5 0 0 0   5 0 0 0   5 0 0 0   5 2 1 0    5 2 1 0    5 2 1 0    5 2 1 0    5 2 1 0    5 2 1 0    5 2 1 0    5 2 1 0    5 2 1 0    5 2 1 0    5 2 1 0    5 0 0 0   5 0 0 0   5 0 0 0   5 0 0 0   5 2 1 0    5 2 1 0   
5 2 1 0    5 2 1 0    5 2 1 0    5 0 0 0   5 0 0 0   5 0 0 0   5 0 0 0   5 0 0 0   5 0 0 0   5 0 0 0   5 0 0 0   5 0 0 0   5 0 0 0   5 2 1 0    5 2 1 0    5 2 1 0    5 2 1 0    5 0 0 0   5 0 0 0   5 0 0 0   5 0 0 0   5 0 0 0   5 0 0 0   5 0 0 0   5 0 0 0   5 0 0 0   5 0 0 0   5 0 0 0   5 0 0 0   5 0 0 0   5 0 0 0   5 0 0 0   5 0 0 0   5 2 1 0    5 2 1 0    5 2 1 0    5 2 1 0    5 2 1 0    5 2 1 0    5 2 1 0    5 2 1 0    5 2 1 0    5 2 1 0    5 2 1 0    5 2 1 0    5 0 0 0   5 0 0 0   5 0 0 0   5 0 0 0   5 2 1 0   
5 2 1 0    5 2 1 0    5 0 0 0   5 0 0 0   5 0 0 0   5 0 0 0   5 0 0 0   5 0 0 0   5 0 0 0   5 0 0 0   5 0 0 0   5 0 0 0   5 2 1 0    5 2 1 0    5 2 1 0    5 2 1 0    5 0 0 0   5 0 0 0   5 0 0 0   5 0 0 0   5 0 0 0   5 0 0 0   5 0 0 0   5 0 0 0   5 0 0 0   5 0 0 0   5 0 0 0   5 0 0 0   5 0 0 0   5 0 0 0   5 0 0 0   5 0 0 0   5 0 0 0   5 0 0 0   5 2 1 0    5 2 1 0    5 2 1 0    5 2 1 0    5 2 1 0    5 2 1 0    5 2 1 0    5 2 1 0    5 2 1 0    5 2 1 0    5 2 1 0    5 0 0 0   5 0 0 0   5 0 0 0   5 0 0 0   5 2 1 0   
5 2 1 0    5 0 0 0   5 0 0 0   5 0 0 0   5 0 0 0   5 0 0 0   5 0 0 0   5 0 0 0   5 0 0 0   5 0 0 0   5 0 0 0   5 2 1 0    5 2 1 0    5 2 1 0    5 2 1 0    5 2 1 0    5 0 0 0   5 0 0 0   5 0 0 0   5 0 0 0   5 0 0 0   5 0 0 0   5 0 0 0   5 0 0 0   5 0 0 0   5 0 0 0   5 0 0 0   5 0 0 0   5 0 0 0   5 0 0 0   5 0 0 0   5 0 0 0   5 0 0 0   5 0 0 0   5 2 1 0    5 2 1 0    5 2 1 0    5 2 1 0    5 2 1 0    5 2 1 0    5 2 1 0    5 2 1 0    5 2 1 0    5 2 1 0    5 2 1 0    5 0 0 0   5 0 0 0   5 0 0 0   5 0 0 0   5 2 1 0    
5 2 1 0    5 0 0 0   5 0 0 0   5 0 0 0   5 0 0 0   5 0 0 0   5 0 0 0   5 0 0 0   5 0 0 0   5 0 0 0   5 2 1 0    5 2 1 0    5 2 1 0    5 2 1 0    5 2 1 0    5 2 1 0    5 0 0 0   5 0 0 0   5 0 0 0   5 0 0 0   5 0 0 0   5 0 0 0   5 0 0 0   5 0 0 0   5 2 1 0    5 2 1 0    5 0 0 0   5 0 0 0   5 0 0 0   5 0 0 0   5 0 0 0   5 0 0 0   5 0 0 0   5 0 0 0   5 2 1 0    5 2 1 0    5 2 1 0    5 2 1 0    5 2 1 0    5 2 1 0    5 2 1 0    5 2 1 0    5 2 1 0    5 2 1 0    5 0 0 0   5 0 0 0   5 0 0 0   5 0 0 0   5 0 0 0   5 2 1 0   
5 2 1 0    5 0 0 0   5 0 0 0   5 0 0 0   5 0 0 0   5 0 0 0   5 0 0 0   5 0 0 0   5 0 0 0   5 2 1 0    5 2 1 0    5 2 1 0    5 2 1 0    5 2 1 0    5 2 1 0    5 0 0 0   5 0 0 0   5 0 0 0   5 0 0 0   5 0 0 0   5 0 0 0   5 0 0 0   5 0 0 0   5 2 1 0    5 2 1 0    5 2 1 0    5 2 1 0    5 0 0 0   5 0 0 0   5 0 0 0   5 0 0 0   5 0 0 0   5 0 0 0   5 0 0 0   5 0 0 0   5 2 1 0    5 2 1 0    5 2 1 0    5 2 1 0    5 2 1 0    5 2 1 0    5 2 1 0    5 2 1 0    5 0 0 0   5 0 0 0   5 0 0 0   5 0 0 0   5 0 0 0   5 0 0 0   5 2 1 0    
5 2 1 0    5 0 0 0   5 0 0 0   5 0 0 0   5 0 0 0   5 0 0 0   5 0 0 0   5 0 0 0   5 0 0 0   5 2 1 0    5 2 1 0    5 2 1 0    5 2 1 0    5 2 1 0    5 2 1 0    5 0 0 0   5 0 0 0   5 0 0 0   5 0 0 0   5 0 0 0   5 0 0 0   5 0 0 0   5 0 0 0   5 2 1 0    5 2 1 0    5 2 1 0    5 2 1 0    5 0 0 0   5 0 0 0   5 0 0 0   5 0 0 0   5 0 0 0   5 0 0 0   5 0 0 0   5 0 0 0   5 2 1 0    5 2 1 0    5 2 1 0    5 2 1 0    5 2 1 0    5 2 1 0    5 2 1 0    5 0 0 0   5 0 0 0   5 0 0 0   5 0 0 0   5 0 0 0   5 0 0 0   5 0 0 0   5 2 1 0   
5 2 1 0    5 0 0 0   5 0 0 0   5 0 0 0   5 0 0 0   5 0 0 0   5 0 0 0   5 0 0 0   5 2 1 0    5 2 1 0    5 2 1 0    5 2 1 0    5 2 1 0    5 2 1 0    5 2 1 0    5 0 0 0   5 0 0 0   5 0 0 0   5 0 0 0   5 0 0 0   5 0 0 0   5 0 0 0   5 0 0 0   5 2 1 0    5 2 1 0    5 2 1 0    5 2 1 0    5 0 0 0   5 0 0 0   5 0 0 0   5 0 0 0   5 0 0 0   5 0 0 0   5 0 0 0   5 0 0 0   5 2 1 0    5 2 1 0    5 2 1 0    5 2 1 0    5 2 1 0    5 2 1 0    5 0 0 0   5 0 0 0   5 0 0 0   5 0 0 0   5 0 0 0   5 0 0 0   5 0 0 0   5 0 0 0   5 2 1 0    
5 2 1 0    5 0 0 0   5 0 0 0   5 0 0 0   5 0 0 0   5 0 0 0   5 0 0 0   5 2 1 0    5 2 1 0    5 2 1 0    5 2 1 0    5 2 1 0    5 2 1 0    5 2 1 0    5 2 1 0    5 0 0 0   5 0 0 0   5 0 0 0   5 0 0 0   5 0 0 0   5 0 0 0   5 0 0 0   5 0 0 0   5 2 1 0    5 2 1 0    5 2 1 0    5 2 1 0    5 0 0 0   5 0 0 0   5 0 0 0   5 0 0 0   5 0 0 0   5 0 0 0   5 0 0 0   5 0 0 0   5 2 1 0    5 2 1 0    5 2 1 0    5 2 1 0    5 2 1 0    5 2 1 0    5 0 0 0   5 0 0 0   5 0 0 0   5 0 0 0   5 0 0 0   5 0 0 0   5 0 0 0   5 0 0 0   5 2 1 0    
5 2 1 0    5 0 0 0   5 0 0 0   5 0 0 0   5 0 0 0   5 0 0 0   5 2 1 0    5 2 1 0    5 2 1 0    5 2 1 0    5 2 1 0    5 2 1 0    5 2 1 0    5 2 1 0    5 2 1 0    5 2 1 0    5 0 0 0   5 0 0 0   5 0 0 0   5 0 0 0   5 0 0 0   5 0 0 0   5 0 0 0   5 0 0 0   5 2 1 0    5 2 1 0    5 0 0 0   5 0 0 0   5 0 0 0   5 0 0 0   5 0 0 0   5 0 0 0   5 0 0 0   5 0 0 0   5 2 1 0    5 2 1 0    5 2 1 0    5 2 1 0    5 2 1 0    5 2 1 0    5 0 0 0   5 0 0 0   5 0 0 0   5 0 0 0   5 0 0 0   5 0 0 0   5 0 0 0   5 0 0 0   5 0 0 0   5 2 1 0    
5 2 1 0    5 0 0 0   5 0 0 0   5 0 0 0   5 0 0 0   5 2 1 0    5 2 1 0    5 2 1 0    5 2 1 0    5 2 1 0    5 2 1 0    5 2 1 0    5 2 1 0    5 2 1 0    5 2 1 0    5 2 1 0    5 0 0 0   5 0 0 0   5 0 0 0   5 0 0 0   5 0 0 0   5 0 0 0   5 0 0 0   5 0 0 0   5 0 0 0   5 0 0 0   5 0 0 0   5 0 0 0   5 0 0 0   5 0 0 0   5 0 0 0   5 0 0 0   5 0 0 0   5 0 0 0   5 2 1 0    5 2 1 0    5 2 1 0    5 2 1 0    5 2 1 0    5 0 0 0   5 0 0 0   5 0 0 0   5 0 0 0   5 0 0 0   5 0 0 0   5 0 0 0   5 0 0 0   5 0 0 0   5 0 0 0   5 2 1 0    
5 2 1 0    5 0 0 0   5 0 0 0   5 0 0 0   5 0 0 0   5 2 1 0    5 2 1 0    5 2 1 0    5 2 1 0    5 2 1 0    5 2 1 0    5 2 1 0    5 2 1 0    5 2 1 0    5 2 1 0    5 2 1 0    5 0 0 0   5 0 0 0   5 0 0 0   5 0 0 0   5 0 0 0   5 0 0 0   5 0 0 0   5 0 0 0   5 0 0 0   5 0 0 0   5 0 0 0   5 0 0 0   5 0 0 0   5 0 0 0   5 0 0 0   5 0 0 0   5 0 0 0   5 0 0 0   5 2 1 0    5 2 1 0    5 2 1 0    5 2 1 0    5 0 0 0   5 0 0 0   5 0 0 0   5 0 0 0   5 0 0 0   5 0 0 0   5 0 0 0   5 0 0 0   5 0 0 0   5 0 0 0   5 2 1 0    5 2 1 0    
5 2 1 0    5 0 0 0   5 0 0 0   5 0 0 0   5 0 0 0   5 2 1 0    5 2 1 0    5 2 1 0    5 2 1 0    5 2 1 0    5 2 1 0    5 2 1 0    5 2 1 0    5 2 1 0    5 2 1 0    5 2 1 0    5 2 1 0    5 0 0 0   5 0 0 0   5 0 0 0   5 0 0 0   5 0 0 0   5 0 0 0   5 0 0 0   5 0 0 0   5 0 0 0   5 0 0 0   5 0 0 0   5 0 0 0   5 0 0 0   5 0 0 0   5 0 0 0   5 0 0 0   5 2 1 0    5 2 1 0    5 2 1 0    5 2 1 0    5 0 0 0   5 0 0 0   5 0 0 0   5 0 0 0   5 0 0 0   5 0 0 0   5 0 0 0   5 0 0 0   5 0 0 0   5 0 0 0   5 2 1 0    5 2 1 0    5 2 1 0    
5 2 1 0    5 2 1 0    5 0 0 0   5 0 0 0   5 0 0 0   5 0 0 0   5 2 1 0    5 2 1 0    5 2 1 0    5 2 1 0    5 2 1 0    5 2 1 0    5 2 1 0    5 2 1 0    5 2 1 0    5 2 1 0    5 2 1 0    5 0 0 0   5 0 0 0   5 0 0 0   5 0 0 0   5 0 0 0   5 0 0 0   5 0 0 0   5 0 0 0   5 0 0 0   5 0 0 0   5 0 0 0   5 0 0 0   5 0 0 0   5 0 0 0   5 0 0 0   5 0 0 0   5 0 0 0   5 0 0 0   5 0 0 0   5 0 0 0   5 0 0 0   5 0 0 0   5 0 0 0   5 0 0 0   5 0 0 0   5 0 0 0   5 0 0 0   5 0 0 0   5 0 0 0   5 2 1 0    5 2 1 0    5 2 1 0    5 2 1 0    
5 2 1 0    5 2 1 0    5 0 0 0   5 0 0 0   5 0 0 0   5 0 0 0   5 0 0 0   5 0 0 0   5 2 1 0    5 2 1 0    5 2 1 0    5 2 1 0    5 2 1 0    5 2 1 0    5 2 1 0    5 2 1 0    5 2 1 0    5 2 1 0    5 0 0 0   5 0 0 0   5 0 0 0   5 0 0 0   5 0 0 0   5 0 0 0   5 0 0 0   5 0 0 0   5 0 0 0   5 0 0 0   5 0 0 0   5 0 0 0   5 0 0 0   5 0 0 0   5 0 0 0   5 0 0 0   5 0 0 0   5 0 0 0   5 0 0 0   5 0 0 0   5 0 0 0   5 0 0 0   5 0 0 0   5 0 0 0   5 0 0 0   5 0 0 0   5 0 0 0   5 0 0 0   5 2 1 0    5 2 1 0    5 2 1 0    5 2 1 0    
5 2 1 0    5 0 0 0   5 0 0 0   5 0 0 0   5 0 0 0   5 0 0 0   5 0 0 0   5 0 0 0   5 0 0 0   5 0 0 0   5 0 0 0   5 0 0 0   5 0 0 0   5 0 0 0   5 0 0 0   5 2 1 0    5 2 1 0    5 0 0 0   5 0 0 0   5 0 0 0   5 0 0 0   5 0 0 0   5 0 0 0   5 0 0 0   5 0 0 0   5 0 0 0   5 0 0 0   5 0 0 0   5 0 0 0   5 0 0 0   5 0 0 0   5 0 0 0   5 0 0 0   5 0 0 0   5 0 0 0   5 0 0 0   5 0 0 0   5 0 0 0   5 0 0 0   5 0 0 0   5 0 0 0   5 0 0 0   5 0 0 0   5 0 0 0   5 0 0 0   5 2 1 0    5 2 1 0    5 2 1 0    5 2 1 0    5 2 1 0    
5 2 1 0    5 0 0 0   5 0 0 0   5 0 0 0   5 0 0 0   5 0 0 0   5 0 0 0   5 0 0 0   5 0 0 0   5 0 0 0   5 0 0 0   5 0 0 0   5 0 0 0   5 0 0 0   5 0 0 0   5 0 0 0   5 0 0 0   5 0 0 0   5 0 0 0   5 0 0 0   5 2 1 0    5 2 1 0    5 0 0 0   5 0 0 0   5 0 0 0   5 0 0 0   5 0 0 0   5 0 0 0   5 0 0 0   5 2 1 0    5 2 1 0    5 0 0 0   5 0 0 0   5 0 0 0   5 0 0 0   5 0 0 0   5 0 0 0   5 0 0 0   5 0 0 0   5 0 0 0   5 0 0 0   5 0 0 0   5 0 0 0   5 0 0 0   5 0 0 0   5 2 1 0    5 2 1 0    5 2 1 0    5 2 1 0    5 2 1 0    
5 2 1 0    5 0 0 0   5 0 0 0   5 0 0 0   5 0 0 0   5 0 0 0   5 0 0 0   5 0 0 0   5 0 0 0   5 0 0 0   5 0 0 0   5 0 0 0   5 0 0 0   5 0 0 0   5 0 0 0   5 0 0 0   5 0 0 0   5 0 0 0   5 0 0 0   5 0 0 0   5 0 0 0   5 2 1 0    5 2 1 0    5 2 1 0    5 2 1 0    5 2 1 0    5 2 1 0    5 2 1 0    5 2 1 0    5 2 1 0    5 0 0 0   5 0 0 0   5 0 0 0   5 0 0 0   5 0 0 0   5 0 0 0   5 0 0 0   5 0 0 0   5 0 0 0   5 0 0 0   5 0 0 0   5 0 0 0   5 0 0 0   5 0 0 0   5 0 0 0   5 2 1 0    5 2 1 0    5 2 1 0    5 2 1 0    5 2 1 0    
5 2 1 0    5 0 0 0   5 0 0 0   5 0 0 0   5 0 0 0   5 0 0 0   5 0 0 0   5 2 1 0    5 2 1 0    5 2 1 0    5 2 1 0    5 2 1 0    5 2 1 0    5 0 0 0   5 0 0 0   5 0 0 0   5 0 0 0   5 0 0 0   5 0 0 0   5 0 0 0   5 0 0 0   5 0 0 0   5 0 0 0   5 0 0 0   5 0 0 0   5 0 0 0   5 0 0 0   5 0 0 0   5 0 0 0   5 0 0 0   5 0 0 0   5 0 0 0   5 0 0 0   5 0 0 0   5 0 0 0   5 0 0 0   5 0 0 0   5 0 0 0   5 0 0 0   5 0 0 0   5 0 0 0   5 0 0 0   5 0 0 0   5 0 0 0   5 0 0 0   5 0 0 0   5 2 1 0    5 2 1 0    5 2 1 0    5 2 1 0    
5 2 1 0    5 0 0 0   5 0 0 0   5 0 0 0   5 0 0 0   5 2 1 0    5 2 1 0    5 2 1 0    5 2 1 0    5 0 0 0   5 0 0 0   5 0 0 0   5 0 0 0   5 0 0 0   5 0 0 0   5 0 0 0   5 0 0 0   5 0 0 0   5 0 0 0   5 0 0 0   5 0 0 0   5 0 0 0   5 0 0 0   5 0 0 0   5 0 0 0   5 0 0 0   5 0 0 0   5 0 0 0   5 0 0 0   5 0 0 0   5 0 0 0   5 0 0 0   5 0 0 0   5 0 0 0   5 0 0 0   5 0 0 0   5 0 0 0   5 0 0 0   5 0 0 0   5 0 0 0   5 0 0 0   5 0 0 0   5 0 0 0   5 0 0 0   5 0 0 0   5 0 0 0   5 2 1 0    5 2 1 0    5 2 1 0    5 2 1 0    
5 2 1 0    5 0 0 0   5 0 0 0   5 0 0 0   5 2 1 0    5 2 1 0    5 2 1 0    5 2 1 0    5 0 0 0   5 0 0 0   5 0 0 0   5 0 0 0   5 0 0 0   5 0 0 0   5 0 0 0   5 0 0 0   5 0 0 0   5 0 0 0   5 0 0 0   5 2 1 0    5 2 1 0    5 0 0 0   5 0 0 0   5 0 0 0   5 0 0 0   5 0 0 0   5 0 0 0   5 0 0 0   5 0 0 0   5 0 0 0   5 0 0 0   5 0 0 0   5 0 0 0   5 0 0 0   5 0 0 0   5 0 0 0   5 0 0 0   5 0 0 0   5 0 0 0   5 0 0 0   5 0 0 0   5 0 0 0   5 0 0 0   5 0 0 0   5 0 0 0   5 0 0 0   5 0 0 0   5 2 1 0    5 2 1 0    5 2 1 0    
5 2 1 0    5 0 0 0   5 0 0 0   5 0 0 0   5 2 1 0    5 2 1 0    5 2 1 0    5 0 0 0   5 0 0 0   5 0 0 0   5 0 0 0   5 0 0 0   5 0 0 0   5 0 0 0   5 0 0 0   5 0 0 0   5 0 0 0   5 0 0 0   5 2 1 0    5 2 1 0    5 2 1 0    5 2 1 0    5 0 0 0   5 0 0 0   5 0 0 0   5 0 0 0   5 0 0 0   5 0 0 0   5 0 0 0   5 0 0 0   5 0 0 0   5 0 0 0   5 0 0 0   5 0 0 0   5 0 0 0   5 0 0 0   5 0 0 0   5 0 0 0   5 0 0 0   5 0 0 0   5 0 0 0   5 0 0 0   5 0 0 0   5 0 0 0   5 0 0 0   5 0 0 0   5 0 0 0   5 2 1 0    5 2 1 0    5 2 1 0    
5 2 1 0    5 0 0 0   5 0 0 0   5 0 0 0   5 0 0 0   5 2 1 0    5 0 0 0   5 0 0 0   5 0 0 0   5 0 0 0   5 0 0 0   5 0 0 0   5 0 0 0   5 0 0 0   5 0 0 0   5 0 0 0   5 0 0 0   5 0 0 0   5 0 0 0   5 2 1 0    5 2 1 0    5 2 1 0    5 2 1 0    5 0 0 0   5 0 0 0   5 0 0 0   5 0 0 0   5 0 0 0   5 0 0 0   5 0 0 0   5 2 1 0    5 2 1 0    5 2 1 0    5 0 0 0   5 0 0 0   5 0 0 0   5 0 0 0   5 0 0 0   5 0 0 0   5 0 0 0   5 0 0 0   5 0 0 0   5 0 0 0   5 0 0 0   5 0 0 0   5 0 0 0   5 0 0 0   5 2 1 0    5 2 1 0    5 2 1 0    
5 2 1 0    5 0 0 0   5 0 0 0   5 0 0 0   5 0 0 0   5 0 0 0   5 0 0 0   5 0 0 0   5 0 0 0   5 0 0 0   5 0 0 0   5 0 0 0   5 0 0 0   5 0 0 0   5 0 0 0   5 0 0 0   5 0 0 0   5 0 0 0   5 0 0 0   5 2 1 0    5 2 1 0    5 2 1 0    5 0 0 0   5 0 0 0   5 0 0 0   5 0 0 0   5 0 0 0   5 0 0 0   5 0 0 0   5 2 1 0    5 2 1 0    5 2 1 0    5 2 1 0    5 2 1 0    5 0 0 0   5 0 0 0   5 0 0 0   5 0 0 0   5 0 0 0   5 0 0 0   5 0 0 0   5 0 0 0   5 0 0 0   5 0 0 0   5 0 0 0   5 0 0 0   5 1 2 2   5 2 1 0    5 2 1 0    5 2 1 0    
5 2 1 0    5 0 0 0   5 0 0 0   5 0 0 0   5 0 0 0   5 0 0 0   5 0 0 0   5 0 0 0   5 0 0 0   5 0 0 0   5 0 0 0   5 0 0 0   5 0 0 0   5 0 0 0   5 0 0 0   5 0 0 0   5 0 0 0   5 0 0 0   5 0 0 0   5 0 0 0   5 0 0 0   5 0 0 0   5 0 0 0   5 0 0 0   5 0 0 0   5 0 0 0   5 0 0 0   5 0 0 0   5 0 0 0   5 2 1 0    5 2 1 0    5 2 1 0    5 2 1 0    5 2 1 0    5 2 1 0    5 0 0 0   5 0 0 0   5 0 0 0   5 0 0 0   5 0 0 0   5 0 0 0   5 0 0 0   5 0 0 0   5 0 0 0   5 0 0 0   5 0 0 0   5 0 0 0   5 0 0 0   5 2 1 0    5 2 1 0    
5 2 1 0    5 2 1 0    5 0 0 0   5 0 0 0   5 0 0 0   5 0 0 0   5 0 0 0   5 0 0 0   5 0 0 0   5 0 0 0   5 0 0 0   5 0 0 0   5 0 0 0   5 0 0 0   5 0 0 0   5 0 0 0   5 0 0 0   5 0 0 0   5 0 0 0   5 0 0 0   5 0 0 0   5 0 0 0   5 0 0 0   5 0 0 0   5 0 0 0   5 0 0 0   5 0 0 0   5 0 0 0   5 2 1 0    5 2 1 0    5 2 1 0    5 2 1 0    5 2 1 0    5 2 1 0    5 2 1 0    5 0 0 0   5 0 0 0   5 0 0 0   5 0 0 0   5 0 0 0   5 0 0 0   5 0 0 0   5 0 0 0   5 0 0 0   5 0 0 0   5 0 0 0   5 0 0 0   5 0 0 0   5 2 1 0    5 2 1 0    
5 2 1 0    5 2 1 0    5 0 0 0   5 0 0 0   5 0 0 0   5 0 0 0   5 0 0 0   5 0 0 0   5 0 0 0   5 0 0 0   5 0 0 0   5 0 0 0   5 0 0 0   5 0 0 0   5 0 0 0   5 0 0 0   5 0 0 0   5 0 0 0   5 0 0 0   5 0 0 0   5 0 0 0   5 0 0 0   5 0 0 0   5 0 0 0   5 0 0 0   5 0 0 0   5 0 0 0   5 0 0 0   5 2 1 0    5 2 1 0    5 2 1 0    5 2 1 0    5 2 1 0    5 2 1 0    5 2 1 0    5 2 1 0    5 2 1 0    5 2 1 0    5 0 0 0   5 0 0 0   5 1 0 2   5 1 0 2   5 1 0 2   5 1 0 2   5 1 0 2   5 1 1 2   5 1 1 2   5 1 1 2   5 2 1 0    5 2 1 0    
5 2 1 0    5 2 1 0    5 0 0 0   5 0 0 0   5 0 0 0   5 0 0 0   5 0 0 0   5 0 0 0   5 0 0 0   5 0 0 0   5 0 0 0   5 0 0 0   5 0 0 0   5 0 0 0   5 0 0 0   5 0 0 0   5 0 0 0   5 0 0 0   5 2 1 0    5 2 1 0    5 2 1 0    5 2 1 0    5 0 0 0   5 0 0 0   5 0 0 0   5 0 0 0   5 0 0 0   5 0 0 0   5 2 1 0    5 2 1 0    5 2 1 0    5 2 1 0    5 2 1 0    5 2 1 0    5 2 1 0    5 2 1 0    5 2 1 0    5 2 1 0    5 2 1 0    5 0 0 0   5 1 0 2   5 1 0 2   5 1 0 2   5 1 0 2   5 1 0 2   5 1 1 2   5 1 1 2   5 1 1 2   5 2 1 0    5 2 1 0    
5 2 1 0    5 2 1 0    5 2 1 0    5 0 0 0   5 0 0 0   5 0 0 0   5 0 0 0   5 0 0 0   5 0 0 0   5 0 0 0   5 0 0 0   5 0 0 0   5 0 0 0   5 0 0 0   5 0 0 0   5 0 0 0   5 0 0 0   5 2 1 0    5 2 1 0    5 2 1 0    5 2 1 0    5 2 1 0    5 0 0 0   5 0 0 0   5 0 0 0   5 0 0 0   5 0 0 0   5 2 1 0    5 2 1 0    5 2 1 0    5 2 1 0    5 2 1 0    5 2 1 0    5 2 1 0    5 2 1 0    5 2 1 0    5 2 1 0    5 2 1 0    5 2 1 0    5 2 1 0    5 2 1 0    5 2 1 0    5 2 1 0    5 0 0 0   5 0 0 0   5 0 0 0   5 0 0 0   5 0 0 0   5 0 0 0   5 2 1 0    
5 2 1 0    5 2 1 0    5 2 1 0    5 2 1 0    5 0 0 0   5 0 0 0   5 0 0 0   5 0 0 0   5 0 0 0   5 0 0 0   5 0 0 0   5 0 0 0   5 0 0 0   5 0 0 0   5 0 0 0   5 0 0 0   5 0 0 0   5 0 0 0   5 2 1 0    5 2 1 0    5 2 1 0    5 2 1 0    5 0 0 0   5 0 0 0   5 0 0 0   5 0 0 0   5 2 1 0    5 2 1 0    5 2 1 0    5 2 1 0    5 2 1 0    5 2 1 0    5 2 1 0    5 2 1 0    5 2 1 0    5 2 1 0    5 2 1 0    5 2 1 0    5 2 1 0    5 2 1 0    5 2 1 0    5 2 1 0    5 2 1 0    5 2 1 0    5 2 1 0    5 0 0 0   5 0 0 0   5 0 0 0   5 0 0 0   5 2 1 0    
5 2 1 0    5 2 1 0    5 2 1 0    5 2 1 0    5 2 1 0    5 2 1 0    5 0 0 0   5 0 0 0   5 0 0 0   5 0 0 0   5 0 0 0   5 0 0 0   5 0 0 0   5 0 0 0   5 0 0 0   5 0 0 0   5 0 0 0   5 0 0 0   5 0 0 0   5 0 0 0   5 0 0 0   5 0 0 0   5 0 0 0   5 0 0 0   5 0 0 0   5 0 0 0   5 2 1 0    5 2 1 0    5 2 1 0    5 2 1 0    5 2 1 0    5 2 1 0    5 2 1 0    5 2 1 0    5 2 1 0    5 2 1 0    5 2 1 0    5 2 1 0    5 2 1 0    5 2 1 0    5 2 1 0    5 2 1 0    5 2 1 0    5 2 1 0    5 2 1 0    5 2 1 0    5 0 0 0   5 0 0 0   5 2 1 0    5 2 1 0    
5 2 1 0    5 2 1 0    5 2 1 0    5 2 1 0    5 2 1 0    5 2 1 0    5 2 1 0    5 2 1 0    5 2 1 0    5 0 0 0   5 0 0 0   5 0 0 0   5 0 0 0   5 0 0 0   5 0 0 0   5 0 0 0   5 0 0 0   5 0 0 0   5 0 0 0   5 0 0 0   5 0 0 0   5 0 0 0   5 0 0 0   5 0 0 0   5 0 0 0   5 2 1 0    5 2 1 0    5 2 1 0    5 2 1 0    5 2 1 0    5 2 1 0    5 2 1 0    5 2 1 0    5 2 1 0    5 2 1 0    5 2 1 0    5 2 1 0    5 2 1 0    5 2 1 0    5 2 1 0    5 2 1 0    5 2 1 0    5 2 1 0    5 2 1 0    5 2 1 0    5 2 1 0    5 2 1 0    5 2 1 0    5 2 1 0    5 2 1 0    
